Country,WHOREGION,FLUREGION,Year,Week,SDATE,EDATE,SPEC_RECEIVED_NB,SPEC_PROCESSED_NB,AH1,AH1N12009,AH3,AH5,ANOTSUBTYPED,INF_A,BYAMAGATA,BVICTORIA,BNOTDETERMINED,INF_B,ALL_INF,ALL_INF2,TITLE

Colombia,Region of the Americas of WHO,Tropical South America,2017,1,2017-01-02,2017-01-08,,173,0,9,7,,0,16,,,5,5,21,152,No Report

Colombia,Region of the Americas of WHO,Tropical South America,2017,2,2017-01-09,2017-01-15,,202,0,8,6,,0,14,,,6,6,20,182,No Report

Colombia,Region of the Americas of WHO,Tropical South America,2017,3,2017-01-16,2017-01-22,,206,0,11,10,,0,21,,,7,7,28,178,No Report

Colombia,Region of the Americas of WHO,Tropical South America,2017,4,2017-01-23,2017-01-29,,200,0,8,7,,0,15,,,4,4,19,181,No Report

Colombia,Region of the Americas of WHO,Tropical South America,2017,5,2017-01-30,2017-02-05,,194,0,8,6,,0,14,,,2,2,16,178,No Report

Colombia,Region of the Americas of WHO,Tropical South America,2017,6,2017-02-06,2017-02-12,,170,0,4,8,,0,12,,,4,4,16,154,No Report

Colombia,Region of the Americas of WHO,Tropical South America,2017,7,2017-02-13,2017-02-19,,217,0,4,10,,0,14,,,4,4,18,199,No Report

Colombia,Region of the Americas of WHO,Tropical South America,2017,8,2017-02-20,2017-02-26,,184,0,4,6,,0,10,,,3,3,13,171,No Report

Colombia,Region of the Americas of WHO,Tropical South America,2017,9,2017-02-27,2017-03-05,,208,0,3,8,,0,11,,,3,3,14,194,No Report

Colombia,Region of the Americas of WHO,Tropical South America,2017,10,2017-03-06,2017-03-12,,253,0,2,7,,0,9,,,2,2,11,242,No Report

Colombia,Region of the Americas of WHO,Tropical South America,2017,11,2017-03-13,2017-03-19,,254,0,2,6,,0,8,,,3,3,11,243,No Report

Colombia,Region of the Americas of WHO,Tropical South America,2017,12,2017-03-20,2017-03-26,,277,0,1,9,,0,10,,,3,3,13,264,No Report

Colombia,Region of the Americas of WHO,Tropical South America,2017,13,2017-03-27,2017-04-02,,286,0,0,9,,0,9,,,3,3,12,274,No Report

Colombia,Region of the Americas of WHO,Tropical South America,2017,14,2017-04-03,2017-04-09,,320,0,0,8,,0,8,,,2,2,10,310,No Report

Colombia,Region of the Americas of WHO,Tropical South America,2017,15,2017-04-10,2017-04-16,,299,0,0,10,,0,10,,,3,3,13,286,No Report

Colombia,Region of the Americas of WHO,Tropical South America,2017,16,2017-04-17,2017-04-23,,294,0,1,9,,0,10,,,3,3,13,281,No Report

Colombia,Region of the Americas of WHO,Tropical South America,2017,17,2017-04-24,2017-04-30,,286,0,0,8,,0,8,,,4,4,12,274,No Report

Colombia,Region of the Americas of WHO,Tropical South America,2017,18,2017-05-01,2017-05-07,,290,0,0,9,,0,9,,,3,3,12,278,No Report

Colombia,Region of the Americas of WHO,Tropical South America,2017,19,2017-05-08,2017-05-14,,281,0,0,9,,0,9,,,4,4,13,268,No Report

Colombia,Region of the Americas of WHO,Tropical South America,2017,20,2017-05-15,2017-05-21,,306,0,0,8,,0,8,,,4,4,12,294,No Report

Colombia,Region of the Americas of WHO,Tropical South America,2017,21,2017-05-22,2017-05-28,,299,0,0,9,,0,9,,,6,6,15,284,No Report

Colombia,Region of the Americas of WHO,Tropical South America,2017,22,2017-05-29,2017-06-04,,273,0,1,10,,0,11,,,5,5,16,257,No Report

Colombia,Region of the Americas of WHO,Tropical South America,2017,23,2017-06-05,2017-06-11,,254,0,0,12,,0,12,,,5,5,17,237,No Report

Colombia,Region of the Americas of WHO,Tropical South America,2017,24,2017-06-12,2017-06-18,,265,0,0,12,,0,12,,,4,4,16,249,No Report

Colombia,Region of the Americas of WHO,Tropical South America,2017,25,2017-06-19,2017-06-25,,254,0,0,11,,0,11,,,5,5,16,238,No Report

Colombia,Region of the Americas of WHO,Tropical South America,2017,26,2017-06-26,2017-07-02,,248,0,1,9,,0,10,,,5,5,15,233,No Report

Colombia,Region of the Americas of WHO,Tropical South America,2017,27,2017-07-03,2017-07-09,,238,0,0,10,,0,10,,,4,4,14,224,No Report

Colombia,Region of the Americas of WHO,Tropical South America,2017,28,2017-07-10,2017-07-16,,253,0,0,10,,0,10,,,4,4,14,239,No Report

Colombia,Region of the Americas of WHO,Tropical South America,2017,29,2017-07-17,2017-07-23,,248,0,0,10,,0,10,,,3,3,13,235,No Report

Colombia,Region of the Americas of WHO,Tropical South America,2017,30,2017-07-24,2017-07-30,,256,0,1,10,,0,11,,,3,3,14,242,No Report

Colombia,Region of the Americas of WHO,Tropical South America,2017,31,2017-07-31,2017-08-06,,247,0,0,12,,0,12,,,3,3,15,232,No Report

Colombia,Region of the Americas of WHO,Tropical South America,2017,32,2017-08-07,2017-08-13,,237,0,0,13,,0,13,,,2,2,15,222,No Report

Colombia,Region of the Americas of WHO,Tropical South America,2017,33,2017-08-14,2017-08-20,,215,0,0,13,,0,13,,,2,2,15,200,No Report

Colombia,Region of the Americas of WHO,Tropical South America,2017,34,2017-08-21,2017-08-27,,223,0,0,13,,0,13,,,2,2,15,208,No Report

Colombia,Region of the Americas of WHO,Tropical South America,2017,35,2017-08-28,2017-09-03,,212,0,0,12,,0,12,,,2,2,14,198,No Report

Colombia,Region of the Americas of WHO,Tropical South America,2017,36,2017-09-04,2017-09-10,,224,0,0,15,,0,15,,,2,2,17,207,No Report

Colombia,Region of the Americas of WHO,Tropical South America,2017,37,2017-09-11,2017-09-17,,231,0,0,15,,0,15,,,1,1,16,215,No Report

Colombia,Region of the Americas of WHO,Tropical South America,2017,38,2017-09-18,2017-09-24,,243,0,0,16,,0,16,,,3,3,19,224,No Report

Colombia,Region of the Americas of WHO,Tropical South America,2017,39,2017-09-25,2017-10-01,,254,0,0,19,,0,19,,,2,2,21,233,No Report

Colombia,Region of the Americas of WHO,Tropical South America,2017,40,2017-10-02,2017-10-08,,224,0,0,21,,0,21,,,1,1,22,202,No Report

Colombia,Region of the Americas of WHO,Tropical South America,2017,41,2017-10-09,2017-10-15,,221,0,0,20,,0,20,,,2,2,22,199,No Report

Colombia,Region of the Americas of WHO,Tropical South America,2017,42,2017-10-16,2017-10-22,,257,0,0,20,,0,20,,,1,1,21,236,No Report

Colombia,Region of the Americas of WHO,Tropical South America,2017,43,2017-10-23,2017-10-29,,261,0,0,19,,0,19,,,2,2,21,240,No Report

Colombia,Region of the Americas of WHO,Tropical South America,2017,44,2017-10-30,2017-11-05,,246,0,0,18,,0,18,,,3,3,21,225,No Report

Colombia,Region of the Americas of WHO,Tropical South America,2017,45,2017-11-06,2017-11-12,,248,0,0,15,,0,15,,,3,3,18,230,No Report

Colombia,Region of the Americas of WHO,Tropical South America,2017,46,2017-11-13,2017-11-19,,243,0,0,14,,0,14,,,2,2,16,227,No Report

Colombia,Region of the Americas of WHO,Tropical South America,2017,47,2017-11-20,2017-11-26,,240,0,0,13,,0,13,,,2,2,15,225,No Report

Colombia,Region of the Americas of WHO,Tropical South America,2017,48,2017-11-27,2017-12-03,,238,0,0,13,,0,13,,,1,1,14,224,No Report

Colombia,Region of the Americas of WHO,Tropical South America,2017,49,2017-12-04,2017-12-10,,211,0,0,11,,0,11,,,1,1,12,199,No Report

Colombia,Region of the Americas of WHO,Tropical South America,2017,50,2017-12-11,2017-12-17,,200,0,0,10,,0,10,,,0,0,10,190,No Report

Colombia,Region of the Americas of WHO,Tropical South America,2017,51,2017-12-18,2017-12-24,,215,0,0,10,,0,10,,,2,2,12,203,No Report

Colombia,Region of the Americas of WHO,Tropical South America,2017,52,2017-12-25,2017-12-31,,232,0,0,10,,0,10,,,0,0,10,222,No Report


