Country,WHOREGION,FLUREGION,Year,Week,SDATE,EDATE,SPEC_RECEIVED_NB,SPEC_PROCESSED_NB,AH1,AH1N12009,AH3,AH5,ANOTSUBTYPED,INF_A,BYAMAGATA,BVICTORIA,BNOTDETERMINED,INF_B,ALL_INF,ALL_INF2,TITLE

Thailand,South-East Asia Region of WHO,South-East Asia,2014,1,2013-12-30,2014-01-05,1,0,0,0,0,0,0,0,0,0,0,0,0,,Sporadic

Thailand,South-East Asia Region of WHO,South-East Asia,2014,2,2014-01-06,2014-01-12,112,112,0,5,7,0,0,12,6,0,0,6,18,,Sporadic

Thailand,South-East Asia Region of WHO,South-East Asia,2014,3,2014-01-13,2014-01-19,82,82,0,5,10,0,0,15,1,2,0,3,18,,Sporadic

Thailand,South-East Asia Region of WHO,South-East Asia,2014,4,2014-01-20,2014-01-26,89,89,0,8,11,0,0,19,5,0,1,6,25,,Sporadic

Thailand,South-East Asia Region of WHO,South-East Asia,2014,5,2014-01-27,2014-02-02,102,102,0,13,7,0,0,20,4,0,0,4,24,,Sporadic

Thailand,South-East Asia Region of WHO,South-East Asia,2014,6,2014-02-03,2014-02-09,101,101,0,8,4,0,0,12,7,1,2,10,22,,Sporadic

Thailand,South-East Asia Region of WHO,South-East Asia,2014,7,2014-02-10,2014-02-16,134,134,0,38,3,0,0,41,8,0,1,9,50,,Sporadic

Thailand,South-East Asia Region of WHO,South-East Asia,2014,8,2014-02-17,2014-02-23,128,128,0,30,9,0,0,39,11,1,9,21,60,,Sporadic

Thailand,South-East Asia Region of WHO,South-East Asia,2014,9,2014-02-24,2014-03-02,123,123,0,24,5,0,0,29,10,0,0,10,39,,Sporadic

Thailand,South-East Asia Region of WHO,South-East Asia,2014,10,2014-03-03,2014-03-09,139,139,0,25,3,0,0,28,17,0,0,17,45,,Sporadic

Thailand,South-East Asia Region of WHO,South-East Asia,2014,11,2014-03-10,2014-03-16,135,135,0,27,7,0,0,34,16,1,3,20,54,,Sporadic

Thailand,South-East Asia Region of WHO,South-East Asia,2014,12,2014-03-17,2014-03-23,119,119,0,24,3,0,0,27,10,1,5,16,43,,Sporadic

Thailand,South-East Asia Region of WHO,South-East Asia,2014,13,2014-03-24,2014-03-30,125,125,0,17,3,0,0,20,20,1,0,21,41,,Sporadic

Thailand,South-East Asia Region of WHO,South-East Asia,2014,14,2014-03-31,2014-04-06,136,136,0,23,1,0,0,24,9,0,0,9,33,,Sporadic

Thailand,South-East Asia Region of WHO,South-East Asia,2014,15,2014-04-07,2014-04-13,82,82,0,5,0,0,0,5,5,1,0,6,11,,Sporadic

Thailand,South-East Asia Region of WHO,South-East Asia,2014,16,2014-04-14,2014-04-20,11,11,0,2,0,0,0,2,0,0,0,0,2,,Sporadic

Thailand,South-East Asia Region of WHO,South-East Asia,2014,17,2014-04-21,2014-04-27,149,149,0,13,0,0,0,13,13,0,4,17,30,,Sporadic

Thailand,South-East Asia Region of WHO,South-East Asia,2014,18,2014-04-28,2014-05-04,78,78,0,9,1,0,0,10,6,0,1,7,17,,Sporadic

Thailand,South-East Asia Region of WHO,South-East Asia,2014,19,2014-05-05,2014-05-11,33,33,0,23,0,0,0,23,2,0,0,2,25,,Sporadic

Thailand,South-East Asia Region of WHO,South-East Asia,2014,20,2014-05-12,2014-05-18,114,114,0,10,1,0,0,11,11,2,0,13,24,,Sporadic

Thailand,South-East Asia Region of WHO,South-East Asia,2014,21,2014-05-19,2014-05-25,70,70,0,6,2,0,0,8,6,2,1,9,17,,Sporadic

Thailand,South-East Asia Region of WHO,South-East Asia,2014,22,2014-05-26,2014-06-01,55,55,0,4,4,0,0,8,5,0,3,8,16,,Sporadic

Thailand,South-East Asia Region of WHO,South-East Asia,2014,23,2014-06-02,2014-06-08,81,81,0,4,0,0,0,4,6,0,1,7,11,,Sporadic

Thailand,South-East Asia Region of WHO,South-East Asia,2014,24,2014-06-09,2014-06-15,86,86,0,2,0,0,0,2,4,1,2,7,9,,Sporadic

Thailand,South-East Asia Region of WHO,South-East Asia,2014,25,2014-06-16,2014-06-22,76,76,0,4,1,0,0,5,4,1,12,17,22,,Sporadic

Thailand,South-East Asia Region of WHO,South-East Asia,2014,26,2014-06-23,2014-06-29,74,74,0,3,3,0,0,6,6,0,0,6,12,,Sporadic

Thailand,South-East Asia Region of WHO,South-East Asia,2014,27,2014-06-30,2014-07-06,76,76,0,5,1,0,0,6,8,0,6,14,20,,Sporadic

Thailand,South-East Asia Region of WHO,South-East Asia,2014,28,2014-07-07,2014-07-13,76,76,0,1,5,0,0,6,13,1,7,21,27,,Sporadic

Thailand,South-East Asia Region of WHO,South-East Asia,2014,29,2014-07-14,2014-07-20,86,86,0,4,5,0,0,9,9,2,8,19,28,,Sporadic

Thailand,South-East Asia Region of WHO,South-East Asia,2014,30,2014-07-21,2014-07-27,77,77,0,2,1,0,0,3,13,0,8,21,24,,Sporadic

Thailand,South-East Asia Region of WHO,South-East Asia,2014,31,2014-07-28,2014-08-03,81,81,0,0,2,0,0,2,3,1,6,10,12,,Sporadic

Thailand,South-East Asia Region of WHO,South-East Asia,2014,32,2014-08-04,2014-08-10,91,91,0,1,2,0,0,3,6,0,6,12,15,,Sporadic

Thailand,South-East Asia Region of WHO,South-East Asia,2014,33,2014-08-11,2014-08-17,8,8,0,0,1,0,0,1,0,0,0,0,1,,Sporadic

Thailand,South-East Asia Region of WHO,South-East Asia,2014,34,2014-08-18,2014-08-24,148,148,0,0,19,0,0,19,2,0,12,14,33,,Sporadic

Thailand,South-East Asia Region of WHO,South-East Asia,2014,35,2014-08-25,2014-08-31,86,86,0,2,2,0,0,4,1,0,6,7,11,,Sporadic

Thailand,South-East Asia Region of WHO,South-East Asia,2014,36,2014-09-01,2014-09-07,80,80,0,2,2,0,0,4,0,0,9,9,13,,Sporadic

Thailand,South-East Asia Region of WHO,South-East Asia,2014,37,2014-09-08,2014-09-14,89,89,0,0,5,0,0,5,9,0,1,10,15,,Sporadic

Thailand,South-East Asia Region of WHO,South-East Asia,2014,38,2014-09-15,2014-09-21,43,43,0,0,0,0,0,0,1,0,1,2,2,,Sporadic

Thailand,South-East Asia Region of WHO,South-East Asia,2014,39,2014-09-22,2014-09-28,33,33,0,2,0,0,0,2,0,0,3,3,5,,Sporadic

Thailand,South-East Asia Region of WHO,South-East Asia,2014,40,2014-09-29,2014-10-05,19,19,0,1,2,0,0,3,1,0,1,2,5,,Sporadic

Thailand,South-East Asia Region of WHO,South-East Asia,2014,41,2014-10-06,2014-10-12,37,37,0,3,1,0,0,4,2,0,1,3,7,,Sporadic

Thailand,South-East Asia Region of WHO,South-East Asia,2014,42,2014-10-13,2014-10-19,36,36,0,1,0,0,0,1,2,0,0,2,3,,Sporadic

Thailand,South-East Asia Region of WHO,South-East Asia,2014,43,2014-10-20,2014-10-26,21,21,0,0,2,0,0,2,0,0,1,1,3,,Sporadic

Thailand,South-East Asia Region of WHO,South-East Asia,2014,44,2014-10-27,2014-11-02,27,27,0,0,1,0,0,1,0,0,0,0,1,,Sporadic

Thailand,South-East Asia Region of WHO,South-East Asia,2014,45,2014-11-03,2014-11-09,29,29,0,0,4,0,0,4,1,0,0,1,5,,Sporadic

Thailand,South-East Asia Region of WHO,South-East Asia,2014,46,2014-11-10,2014-11-16,,,0,0,3,0,0,3,1,0,0,1,4,,Sporadic

Thailand,South-East Asia Region of WHO,South-East Asia,2014,47,2014-11-17,2014-11-23,30,30,0,0,5,0,0,5,0,0,0,0,5,,Sporadic

Thailand,South-East Asia Region of WHO,South-East Asia,2014,48,2014-11-24,2014-11-30,25,25,0,0,3,0,0,3,0,0,2,2,5,,Sporadic

Thailand,South-East Asia Region of WHO,South-East Asia,2014,49,2014-12-01,2014-12-07,18,18,0,1,5,0,0,6,0,0,0,0,6,,Sporadic

Thailand,South-East Asia Region of WHO,South-East Asia,2014,50,2014-12-08,2014-12-14,35,35,0,0,6,0,0,6,0,0,0,0,6,,Sporadic

Thailand,South-East Asia Region of WHO,South-East Asia,2014,51,2014-12-15,2014-12-21,27,27,0,0,5,0,0,5,0,0,1,1,6,,Sporadic

Thailand,South-East Asia Region of WHO,South-East Asia,2014,52,2014-12-22,2014-12-28,21,21,0,0,2,0,0,2,0,0,0,0,2,,Sporadic


